"a" = (/turf/flat/floor/grass,/area/outside)
"b" = (/turf/flat/floor/grass,/area/ruin{name = "ruina misterigoza OUTSIDE"; outside = 1})
"c" = (/turf/solid/wall/metal,/area/outside)
"d" = (/turf/flat/floor,/area/outside)
"e" = (/obj/item,/turf/flat/floor/grass,/area/outside)
"f" = (/turf/solid/wall/r_wall,/area/outside)
"g" = (/obj/machine/gun,/turf/flat/floor/grass,/area/outside)
"h" = (/obj/item/equipable/passive/abyssal_starshot,/turf/flat/floor/grass,/area/outside)
"i" = (/mob/living/human,/turf/flat/floor/grass,/area/outside)
"j" = (/mob/living/human/ai,/turf/flat/floor/grass,/area/outside)
"k" = (/turf/flat/floor/gojo,/area/ruin{name = "ruina misterigoza OUTSIDE"; outside = 1})
"l" = (/turf/flat/floor/gojo,/area/outside)

(1,1,1) = {"
bbbbbbbbbbbbbbbbbbbbbbbbbbbbbbbbbbbbbbbbbbbbbbbbbb
bbbbbbbbbbbbbbbbbbbbbbbbbbbbbbbbbbbbbbbbbbbbbbbbbb
bbbbbbbbbbbbbbbbbbbbbbbbbbbbbbbbbbbbbbbbbbbbbbbbbb
bbbbbbbbbbbbbbbbbbbbbbbbbbbbbbbbbbbbbbbbbbbbbbbbbb
bbbbbbbbbbbbbbbbbbbbbbbbbbbbbbbbbbbbbbbbbbbbbbbbbb
bbbbbbbbbbbbbbbbbbbbbbbbbbbbbbbbbbbbbbbbbbbbbbbbbb
bbbbbbbbbbbbbbbbbbbbbbbbbbbbbbbbbbbbbbbbbbbbbbbbbb
bbbbbbbbbbbbbbbbbbbbbbbbbbbbbbbbbbbbbbbbbbbbbbbbbb
bbbbbbbbbbbbbbbbbbbbbbbbbbbbbbbbbbbbbbbbbbbbbbbbbb
bbbbbbbbbbbbbbbbbbbbbbbbbbbbbbbbbbbbbbbbbbbbbbbbbb
bbbbbbbbbbbbbbbbbbbbbbbbbbbbbbbbbbbbbbbbbbbbbbbbbb
bbbbbbbbbbbbbbbbbbbbbbbbbbbbbbbbbbbbbbbbbbbbbbbbbb
bbbbbbbbbbbbbbbbbbbbbbbbbbbbbbbbbbbbbbbbbbbbbbbbbb
bbbbbbbbbbbbbbbbbbbbbbbbbbbbbbbbbbbbbbbbbbbbbbbbbb
bbbbbbbbbbbbbbbbbbbbbbbbbbbbbbbbbbbbbbbbbbbbbbbbbb
bbbbbbbbbbbbbbbbbbbbbbbbbbbbbbbbbbbbbbbbbbbbbbbbbb
bbbbbbbbbbbbbbbbbbbbbbbbbbbbbbbbbbbbbbbbbbbbbbbbbb
bbbbbbbbbbbbbbbbbbbbbbbbbbbbbbbbbbbbbbbbbbbbbbbbbb
bbbbbbbbbbbbbbbbbbbbbbbbbbbbbbbbbbbbbbbbbbbbbbbbbb
bbbbbbbbbbbbbbbbbbbbbbbbbbbbbbbbbbbbbbbbbbbbbbbbbb
bbbbbbbbbbbbbbbbbbbbbbbbbbbbbbbbbbbbbbbbbbbbbbbbbb
bbbbbbbbbbbbbbbbbbbbbbbbbbbbbbbbbbbbbbbbbbbbbbbbbb
bbbbbbbbbbbbbbbbbbbbbbbbbbbbbbbbbbbbbbbbbbbbbbbbbb
bbbbbbbbbbbbbbbbbbbbbbbbbbbbbbbbbbbbbbbbbbbbbbbbbb
bbbbbbbbbbbbbbbbbbbbbbbbbbbbbbbbbbbbbbbbbbbbbbbbbb
bbbbbbbbbbbbbbbbbbbbbbbbbbbbbbbbbbbbbbbbbbbbbbbbbb
bbbbbbbbbbbbbbbbbbbbbbbbbbbbbbbbbbbbbbbbbbbbbbbbbb
bbbbbbbbbbbbbbbbbbbbbbbbbbbbbbbbbbbbbbbbbbbbbbbbbb
bbbbbbbbbbbbbbbbbbbbbbbbbbbbbbbbbbbbbbbbbbbbbbbbbb
bbbbbbbbbbbbbbbbbbbbbbbbbbbbbbbbbbbbbbbbbbbbbbbbbb
bbbbbbbbbbbbbbbbbbbbbbbbbbbbbbbbbbbbbbbbbbbbbbbbbb
bbbbbbbbbbbbbbbbbbbbbbbbbbbbbbbbbbbbbbbbbbbbbbbbbb
bbbbbbbbbbbbbbbbbbbbbbbbbbbbbbbbbbbbbbbbbbbbbbbbbb
bbbbbbbbbbbbbbbbbbbbbbbbbbbbbbbbbbbbbbbbbbbbbbbbbb
bbbbbbbkkbbbbbbbbbbbbbbbbbbbbbbbbbbbbbbbbbbbbbbbbb
kkkbbkkkkkkbbbbbbbbbbbbbbbbbbbbbbbbbbbbbbbbbbbbbbb
kkkkkkkkkkkbbbbbbbbbbbbbbbbbbbbbbbbbbbbbbbbbbbbbbb
kbkkkkkkkbbbbbbbbbbbbbbbbbbbbbbbbbbbbbbbbbbbbbbbbb
laallllaaaaabbbbbbbbbbbbbbbbbbbbbbbbbbbbbbbbbbbbbb
lajallaiiiaabbbbbbbbbbbbbbbbbbbbbbbbbbbbbbbbbbbbbb
llaaaaaiaiaabbbbbbbbbbbbbbbbbbbbbbbbbbbbbbbbbbbbbb
llccccaiaiaabbbbbbbbbbbbbbbbbbbbbbbbbbbbbbbbbbbbbb
lacdddaaaaaabbbbbbbbbbbbbbbbbbbbbbbbbbbbbbbbbbbbbb
aacddddaaaaabbbbbbbbbbbbbbbbbbbbbbbbbbbbbbbbbbbbbb
eefddddafaaabbbbbbbbbbbbbbbbbbbbbbbbbbbbbbbbbbbbbb
eeahddddfaaabbbbbbbbbbbbbbbbbbbbbbbbbbbbbbbbbbbbbb
aaaaddddfaaabbbbbbbbbbbbbbbbbbbbbbbbbbbbbbbbbbbbbb
aagaaaadaaaabbbbbbbbbbbbbbbbbbbbbbbbbbbbbbbbbbbbbb
aaaaaaaaaaaabbbbbbbbbbbbbbbbbbbbbbbbbbbbbbbbbbbbbb
aaaaaaaaaaaabbbbbbbbbbbbbbbbbbbbbbbbbbbbbbbbbbbbbb
"}
